R 640 480

NO ./common/textures/bluestone.xpm
SO ./common/textures/greystone.xpm
WE ./common/textures/redbrick.xpm
EA ./common/textures/purplestone.xpm

S ./common/textures/barrel.xpm
C 255,200,160
F 122,122,122

        1111111111111111111111111
        1000000000110000000000001
        1011000001110000002000201
        1001000000000000000000001
111111111011000001110000000000001
100000000011000001110111110111111
11110111111111011100000010001
11110111111111011101010010201
11000000110101011100000010201
10002000000000001100000010001
10000000000000001101010010001
11000001110101011111011110N0111
11110111 1110101 101111010001
11111111 1111111 111111111111
